EA ./includes/textures/smoke.xpm
NO ./includes/textures/water_texture.xpm
WE ./includes/textures/wall_blackhole.xpm
SO ./includes/textures/wall_snow1.xpm
F 100,100,100
C 135,206,235

1111111111111111111111111
1000000000110000000000001
1011000001110000000000001
10010000000000000000000011111
111110110001D1110000000000001
100000000011000001110111D10111111
11110111111111011100000010001
11110111111111011101010010001
11000000110101011100000010001
10000000000000000000000010001
10000000000000011010100100011
11000001110101011111011110N0111
1111111111111111111111111111111
111111111111111111111111111111
11110111111101011101111010001
11111111111111111111111111111

