EA ./includes/textures/water_texture2.xpm
NO ./includes/textures/water_texture.xpm
WE ./includes/textures/wall_blackhole.xpm
SO ./includes/textures/wall_gold_energy.xpm
F 0,0,0
C 173,216,230

111111111111111
100000000000001
110110000001011
11100000N000011
110000000000011
110000101000011
111111111111111
