EA ./includes/textures/water_texture2.xpm
NO ./includes/textures/water_texture.xpm
WE ./includes/textures/wall_blackhole.xpm
SO ./includes/textures/wall_gold_energy.xpm
F 100,100,100
C 135,206,235


111111111111111
100000000000001
11N1111D1111111
111000000000011
110000000C00011
110000101000011
111111111111111

