EA ./includes/textures/water_texture2.xpm
NO ./includes/textures/water_texture.xpm
WE ./includes/textures/wall_blackhole.xpm
SO ./includes/textures/wall_gold_energy.xpm
F 100,100,100
C 135,206,235



1111111111111111
1000000000000001
1011000001110001
1001000000000001
111110110001D111
1000000000110001
1111011111111101
1111011111111101
1100000011010101
1000000000000001
100000000000W001
1100000111010101
1111011111110101
1111111111111111
