EA ./includes/textures/water_texture2.xpm
NO ./includes/textures/water_texture.xpm
WE ./includes/textures/wall_blackhole.xpm
SO ./includes/textures/wall_gold_energy.xpm
F 220,50,0
C 0,0,250

111111111111111
100000000000001
11N110000001011111111111111111111111111
111000001000000000000000000000000000011
110000000000011111111111111111111111111
110000101000011
111111111111111
