NO ./srcs/imgs/bebe.jpg
SO ./path_to_the_south_texture
WE ./path_to_the_west_texture
EA ./path_to_the_east_texture
F 220,100,0
C 225,30,0
111111111111111
100000000000001
110110000001011
1110000N0000011
110000000000011
110000101000011
111111111111111